10
10
##########
#a9....33#
#9#.-----#
#.#------#
#..0-----#
#+++++5..#
#++++++#.#
#+++++.#9#
#33....09#
##########