10
10
##########
#99....33#
#9#.-----#
#.#------#
#..5-----#
#+++.+5..#
#+++.++#.#
#+++.+.#9#
#33....99#
##########